CHARACTER_SAVED = 570

MMMMDCLXXII	MMMMDCLXXII
MMDCCCLXXXIII	MMDCCCLXXXIII
MMMDLXVIIII	MMMDLXVIV	changed
MMMMDXCV	MMMMDXCV
DCCCLXXII	DCCCLXXII
MMCCCVI	MMCCCVI
MMMCDLXXXVII	MMMCDLXXXVII
MMMMCCXXI	MMMMCCXXI
MMMCCXX	MMMCCXX
MMMMDCCCLXXIII	MMMMDCCCLXXIII
MMMCCXXXVII	MMMCCXXXVII
MMCCCLXXXXIX	MMCCCLXLIX	changed
MDCCCXXIIII	MDCCCXXIV	changed
MMCXCVI	MMCXCVI
CCXCVIII	CCXCVIII
MMMCCCXXXII	MMMCCCXXXII
MDCCXXX	MDCCXXX
MMMDCCCL	MMMDCCCL
MMMMCCLXXXVI	MMMMCCLXXXVI
MMDCCCXCVI	MMDCCCXCVI
MMMDCII	MMMDCII
MMMCCXII	MMMCCXII
MMMMDCCCCI	MMMMCMI	changed
MMDCCCXCII	MMDCCCXCII
MDCXX	MDCXX
CMLXXXVII	CMLXXXVII
MMMXXI	MMMXXI
MMMMCCCXIV	MMMMCCCXIV
MLXXII	MLXXII
MCCLXXVIIII	MCCLXXVIV	changed
MMMMCCXXXXI	MMMMCCXLI	changed
MMDCCCLXXII	MMDCCCLXXII
MMMMXXXI	MMMMXXXI
MMMDCCLXXX	MMMDCCLXXX
MMDCCCLXXIX	MMDCCCLXXIX
MMMMLXXXV	MMMMLXXXV
MCXXI	MCXXI
MDCCCXXXVII	MDCCCXXXVII
MMCCCLXVII	MMCCCLXVII
MCDXXXV	MCDXXXV
CCXXXIII	CCXXXIII
CMXX	CMXX
MMMCLXIV	MMMCLXIV
MCCCLXXXVI	MCCCLXXXVI
DCCCXCVIII	DCCCXCVIII
MMMDCCCCXXXIV	MMMCMXXXIV	changed
CDXVIIII	CDXVIV	changed
MMCCXXXV	MMCCXXXV
MDCCCXXXII	MDCCCXXXII
MMMMD	MMMMD
MMDCCLXIX	MMDCCLXIX
MMMMCCCLXXXXVI	MMMMCCCLXLVI	changed
MMDCCXLII	MMDCCXLII
MMMDCCCVIIII	MMMDCCCVIV	changed
DCCLXXXIIII	DCCLXXXIV	changed
MDCCCCXXXII	MCMXXXII	changed
MMCXXVII	MMCXXVII
DCCCXXX	DCCCXXX
CCLXIX	CCLXIX
MMMXI	MMMXI
MMMMCMLXXXXVIII	MMMMCMLXLVIII	changed
MMMMDLXXXVII	MMMMDLXXXVII
MMMMDCCCLX	MMMMDCCCLX
MMCCLIV	MMCCLIV
CMIX	CMIX
MMDCCCLXXXIIII	MMDCCCLXXXIV	changed
CLXXXII	CLXXXII
MMCCCCXXXXV	MMCCCCXLV	changed
MMMMDLXXXVIIII	MMMMDLXXXVIV	changed
MMMDCCCXXI	MMMDCCCXXI
MMDCCCCLXXVI	MMCMLXXVI	changed
MCCCCLXX	MCDLXX	changed
MMCDLVIIII	MMCDLVIV	changed
MMMDCCCLIX	MMMDCCCLIX
MMMMCCCCXIX	MMMMCDXIX	changed
MMMDCCCLXXV	MMMDCCCLXXV
XXXI	XXXI
CDLXXXIII	CDLXXXIII
MMMCXV	MMMCXV
MMDCCLXIII	MMDCCLXIII
MMDXXX	MMDXXX
MMMMCCCLVII	MMMMCCCLVII
MMMDCI	MMMDCI
MMMMCDLXXXIIII	MMMMCDLXXXIV	changed
MMMMCCCXVI	MMMMCCCXVI
CCCLXXXVIII	CCCLXXXVIII
MMMMCML	MMMMCML
MMMMXXIV	MMMMXXIV
MMMCCCCXXX	MMMCDXXX	changed
DCCX	DCCX
MMMCCLX	MMMCCLX
MMDXXXIII	MMDXXXIII
CCCLXIII	CCCLXIII
MMDCCXIII	MMDCCXIII
MMMCCCXLIV	MMMCCCXLIV
CLXXXXI	CLXLI	changed
CXVI	CXVI
MMMMCXXXIII	MMMMCXXXIII
CLXX	CLXX
DCCCXVIII	DCCCXVIII
MLXVII	MLXVII
DLXXXX	DLXL	changed
MMDXXI	MMDXXI
MMMMDLXXXXVIII	MMMMDLXLVIII	changed
MXXII	MXXII
LXI	LXI
DCCCCXLIII	CMXLIII	changed
MMMMDV	MMMMDV
MMMMXXXIV	MMMMXXXIV
MDCCCLVIII	MDCCCLVIII
MMMCCLXXII	MMMCCLXXII
MMMMDCCXXXVI	MMMMDCCXXXVI
MMMMLXXXIX	MMMMLXXXIX
MDCCCLXXXI	MDCCCLXXXI
MMMMDCCCXV	MMMMDCCCXV
MMMMCCCCXI	MMMMCDXI	changed
MMMMCCCLIII	MMMMCCCLIII
MDCCCLXXI	MDCCCLXXI
MMCCCCXI	MMCDXI	changed
MLXV	MLXV
MMCDLXII	MMCDLXII
MMMMDXXXXII	MMMMDXLII	changed
MMMMDCCCXL	MMMMDCCCXL
MMMMCMLVI	MMMMCMLVI
CCLXXXIV	CCLXXXIV
MMMDCCLXXXVI	MMMDCCLXXXVI
MMCLII	MMCLII
MMMCCCCXV	MMMCDXV	changed
MMLXXXIII	MMLXXXIII
MMMV	MMMV
MMMV	MMMV
DCCLXII	DCCLXII
MMDCCCCXVI	MMCMXVI	changed
MMDCXLVIII	MMDCXLVIII
CCLIIII	CCLIV	changed
CCCXXV	CCCXXV
MMDCCLXXXVIIII	MMDCCLXXXVIV	changed
MMMMDCLXXVIII	MMMMDCLXXVIII
MMMMDCCCXCI	MMMMDCCCXCI
MMMMCCCXX	MMMMCCCXX
MMCCXLV	MMCCXLV
MMMDCCCLXIX	MMMDCCCLXIX
MMCCLXIIII	MMCCLXIV	changed
MMMDCCCXLIX	MMMDCCCXLIX
MMMMCCCLXIX	MMMMCCCLXIX
CMLXXXXI	CMLXLI	changed
MCMLXXXIX	MCMLXXXIX
MMCDLXI	MMCDLXI
MMDCLXXVIII	MMDCLXXVIII
MMMMDCCLXI	MMMMDCCLXI
MCDXXV	MCDXXV
DL	DL
CCCLXXII	CCCLXXII
MXVIIII	MXVIV	changed
MCCCCLXVIII	MCDLXVIII	changed
CIII	CIII
MMMDCCLXXIIII	MMMDCCLXXIV	changed
MMMDVIII	MMMDVIII
MMMMCCCLXXXXVII	MMMMCCCLXLVII	changed
MMDXXVII	MMDXXVII
MMDCCLXXXXV	MMDCCLXLV	changed
MMMMCXLVI	MMMMCXLVI
MMMDCCLXXXII	MMMDCCLXXXII
MMMDXXXVI	MMMDXXXVI
MCXXII	MCXXII
CLI	CLI
DCLXXXIX	DCLXXXIX
MMMCLI	MMMCLI
MDCLXIII	MDCLXIII
MMMMDCCXCVII	MMMMDCCXCVII
MMCCCLXXXV	MMCCCLXXXV
MMMDCXXVIII	MMMDCXXVIII
MMMCDLX	MMMCDLX
MMMCMLII	MMMCMLII
MMMIV	MMMIV
MMMMDCCCLVIII	MMMMDCCCLVIII
MMMDLXXXVIII	MMMDLXXXVIII
MCXXIV	MCXXIV
MMMMLXXVI	MMMMLXXVI
CLXXIX	CLXXIX
MMMCCCCXXVIIII	MMMCCCCXXVIV	changed
DCCLXXXV	DCCLXXXV
MMMDCCCVI	MMMDCCCVI
LI	LI
CLXXXVI	CLXXXVI
MMMMCCCLXXVI	MMMMCCCLXXVI
MCCCLXVI	MCCCLXVI
CCXXXIX	CCXXXIX
MMDXXXXI	MMDXLI	changed
MMDCCCXLI	MMDCCCXLI
DCCCLXXXVIII	DCCCLXXXVIII
MMMMDCCCIV	MMMMDCCCIV
MDCCCCXV	MCMXV	changed
MMCMVI	MMCMVI
MMMMCMLXXXXV	MMMMCMLXLV	changed
MMDCCLVI	MMDCCLVI
MMMMCCXLVIII	MMMMCCXLVIII
DCCCCIIII	DCCCCIV	changed
MMCCCCIII	MMCDIII	changed
MMMDCCLXXXVIIII	MMMDCCLXXXVIV	changed
MDCCCLXXXXV	MDCCCLXLV	changed
DVII	DVII
MMMV	MMMV
DCXXV	DCXXV
MMDCCCXCV	MMDCCCXCV
DCVIII	DCVIII
MMCDLXVI	MMCDLXVI
MCXXVIII	MCXXVIII
MDCCXCVIII	MDCCXCVIII
MMDCLX	MMDCLX
MMMDCCLXIV	MMMDCCLXIV
MMCDLXXVII	MMCDLXXVII
MMDLXXXIIII	MMDLXXXIV	changed
MMMMCCCXXII	MMMMCCCXXII
MMMDCCCXLIIII	MMMDCCCXLIV	changed
DCCCCLXVII	CMLXVII	changed
MMMCLXXXXIII	MMMCLXLIII	changed
MCCXV	MCCXV
MMMMDCXI	MMMMDCXI
MMMMDCLXXXXV	MMMMDCLXLV	changed
MMMCCCLII	MMMCCCLII
MMCMIX	MMCMIX
MMDCCXXV	MMDCCXXV
MMDLXXXVI	MMDLXXXVI
MMMMDCXXVIIII	MMMMDCXXVIV	changed
DCCCCXXXVIIII	DCCCCXXXVIV	changed
MMCCXXXIIII	MMCCXXXIV	changed
MMDCCLXXVIII	MMDCCLXXVIII
MDCCLXVIIII	MDCCLXVIV	changed
MMCCLXXXV	MMCCLXXXV
MMMMDCCCLXXXVIII	MMMMDCCCLXXXVIII
MMCMXCI	MMCMXCI
MDXLII	MDXLII
MMMMDCCXIV	MMMMDCCXIV
MMMMLI	MMMMLI
DXXXXIII	DXLIII	changed
MMDCCXI	MMDCCXI
MMMMCCLXXXIII	MMMMCCLXXXIII
MMMDCCCLXXIII	MMMDCCCLXXIII
MDCLVII	MDCLVII
MMCD	MMCD
MCCCXXVII	MCCCXXVII
MMMMDCCIIII	MMMMDCCIV	changed
MMMDCCXLVI	MMMDCCXLVI
MMMCLXXXVII	MMMCLXXXVII
MMMCCVIIII	MMMCCVIV	changed
MCCCCLXXIX	MCDLXXIX	changed
DL	DL
DCCCLXXVI	DCCCLXXVI
MMDXCI	MMDXCI
MMMMDCCCCXXXVI	MMMMCMXXXVI	changed
MMCII	MMCII
MMMDCCCXXXXV	MMMDCCCXLV	changed
MMMCDXLV	MMMCDXLV
MMDCXXXXIV	MMDCXLIV	changed
MMD	MMD
MDCCCLXXXX	MDCCCLXL	changed
MMDCXLIII	MMDCXLIII
MMCCXXXII	MMCCXXXII
MMDCXXXXVIIII	MMDCXLVIIII	changed
DCCCLXXI	DCCCLXXI
MDXCVIIII	MDXCVIV	changed
MMMMCCLXXVIII	MMMMCCLXXVIII
MDCLVIIII	MDCLVIV	changed
MMMCCCLXXXIX	MMMCCCLXXXIX
MDCLXXXV	MDCLXXXV
MDLVIII	MDLVIII
MMMMCCVII	MMMMCCVII
MMMMDCXIV	MMMMDCXIV
MMMCCCLXIIII	MMMCCCLXIV	changed
MMIIII	MMIV	changed
MMMMCCCLXXIII	MMMMCCCLXXIII
CCIII	CCIII
MMMCCLV	MMMCCLV
MMMDXIII	MMMDXIII
MMMCCCXC	MMMCCCXC
MMMDCCCXXI	MMMDCCCXXI
MMMMCCCCXXXII	MMMMCDXXXII	changed
CCCLVI	CCCLVI
MMMCCCLXXXVI	MMMCCCLXXXVI
MXVIIII	MXVIV	changed
MMMCCCCXIIII	MMMCCCCXIV	changed
CLXVII	CLXVII
MMMCCLXX	MMMCCLXX
CCCCLXIV	CDLXIV	changed
MMXXXXII	MMXLII	changed
MMMMCCLXXXX	MMMMCCLXL	changed
MXL	MXL
CCXVI	CCXVI
CCCCLVIIII	CCCCLVIV	changed
MMCCCII	MMCCCII
MCCCLVIII	MCCCLVIII
MMMMCCCX	MMMMCCCX
MCDLXXXXIV	MCDLXLIV	changed
MDCCCXIII	MDCCCXIII
MMDCCCXL	MMDCCCXL
MMMMCCCXXIII	MMMMCCCXXIII
DXXXIV	DXXXIV
CVI	CVI
MMMMDCLXXX	MMMMDCLXXX
DCCCVII	DCCCVII
MMCMLXIIII	MMCMLXIV	changed
MMMDCCCXXXIII	MMMDCCCXXXIII
DCCC	DCCC
MDIII	MDIII
MMCCCLXVI	MMCCCLXVI
MMMCCCCLXXI	MMMCDLXXI	changed
MMDCCCCXVIII	MMCMXVIII	changed
CCXXXVII	CCXXXVII
CCCXXV	CCCXXV
MDCCCXII	MDCCCXII
MMMCMV	MMMCMV
MMMMCMXV	MMMMCMXV
MMMMDCXCI	MMMMDCXCI
DXXI	DXXI
MMCCXLVIIII	MMCCXLVIV	changed
MMMMCMLII	MMMMCMLII
MDLXXX	MDLXXX
MMDCLXVI	MMDCLXVI
CXXI	CXXI
MMMDCCCLIIII	MMMDCCCLIV	changed
MMMCXXI	MMMCXXI
MCCIII	MCCIII
MMDCXXXXI	MMDCXLI	changed
CCXCII	CCXCII
MMMMDXXXV	MMMMDXXXV
MMMCCCLXV	MMMCCCLXV
MMMMDLXV	MMMMDLXV
MMMCCCCXXXII	MMMCDXXXII	changed
MMMCCCVIII	MMMCCCVIII
DCCCCLXXXXII	DCCCCLXLII	changed
MMCLXIV	MMCLXIV
MMMMCXI	MMMMCXI
MLXXXXVII	MLXLVII	changed
MMMCDXXXVIII	MMMCDXXXVIII
MDXXII	MDXXII
MLV	MLV
MMMMDLXVI	MMMMDLXVI
MMMCXII	MMMCXII
XXXIII	XXXIII
MMMMDCCCXXVI	MMMMDCCCXXVI
MMMLXVIIII	MMMLXVIV	changed
MMMLX	MMMLX
MMMCDLXVII	MMMCDLXVII
MDCCCLVII	MDCCCLVII
MMCXXXVII	MMCXXXVII
MDCCCCXXX	MCMXXX	changed
MMDCCCLXIII	MMDCCCLXIII
MMMMDCXLIX	MMMMDCXLIX
MMMMCMXLVIII	MMMMCMXLVIII
DCCCLXXVIIII	DCCCLXXVIV	changed
MDCCCLIII	MDCCCLIII
MMMCMLXI	MMMCMLXI
MMMMCCLXI	MMMMCCLXI
MMDCCCLIII	MMDCCCLIII
MMMDCCCVI	MMMDCCCVI
MMDXXXXIX	MMDXLIX	changed
MMCLXXXXV	MMCLXLV	changed
MMDXXX	MMDXXX
MMMXIII	MMMXIII
DCLXXIX	DCLXXIX
DCCLXII	DCCLXII
MMMMDCCLXVIII	MMMMDCCLXVIII
MDCCXXXXIII	MDCCXLIII	changed
CCXXXII	CCXXXII
MMMMDCXXV	MMMMDCXXV
MMMCCCXXVIII	MMMCCCXXVIII
MDCVIII	MDCVIII
MMMCLXXXXIIII	MMMCLXLIIII	changed
CLXXXI	CLXXXI
MDCCCCXXXIII	MCMXXXIII	changed
MMMMDCXXX	MMMMDCXXX
MMMDCXXIV	MMMDCXXIV
MMMCCXXXVII	MMMCCXXXVII
MCCCXXXXIIII	MCCCXLIIII	changed
CXVIII	CXVIII
MMDCCCCIV	MMCMIV	changed
MMMMCDLXXV	MMMMCDLXXV
MMMDLXIV	MMMDLXIV
MDXCIII	MDXCIII
MCCLXXXI	MCCLXXXI
MMMDCCCXXIV	MMMDCCCXXIV
MCXLIII	MCXLIII
MMMDCCCI	MMMDCCCI
MCCLXXX	MCCLXXX
CCXV	CCXV
MMDCCLXXI	MMDCCLXXI
MMDLXXXIII	MMDLXXXIII
MMMMDCXVII	MMMMDCXVII
MMMCMLXV	MMMCMLXV
MCLXVIII	MCLXVIII
MMMMCCLXXVI	MMMMCCLXXVI
MMMDCCLXVIIII	MMMDCCLXVIV	changed
MMMMDCCCIX	MMMMDCCCIX
DLXXXXIX	DLXLIX	changed
DCCCXXII	DCCCXXII
MMMMIII	MMMMIII
MMMMCCCLXXVI	MMMMCCCLXXVI
DCCCXCIII	DCCCXCIII
DXXXI	DXXXI
MXXXIIII	MXXXIV	changed
CCXII	CCXII
MMMDCCLXXXIIII	MMMDCCLXXXIV	changed
MMMCXX	MMMCXX
MMMCMXXVII	MMMCMXXVII
DCCCXXXX	DCCCXL	changed
MMCDXXXVIIII	MMCDXXXVIV	changed
MMMMDCCXVIII	MMMMDCCXVIII
LV	LV
MMMDCCCCVI	MMMCMVI	changed
MCCCII	MCCCII
MMCMLXVIIII	MMCMLXVIV	changed
MDCCXI	MDCCXI
MMMMDLXVII	MMMMDLXVII
MMCCCCLXI	MMCDLXI	changed
MMDCCV	MMDCCV
MMMCCCXXXIIII	MMMCCCXXXIV	changed
MMMMDI	MMMMDI
MMMDCCCXCV	MMMDCCCXCV
MMDCCLXXXXI	MMDCCLXLI	changed
MMMDXXVI	MMMDXXVI
MMMDCCCLVI	MMMDCCCLVI
MMDCXXX	MMDCXXX
MCCCVII	MCCCVII
MMMMCCCLXII	MMMMCCCLXII
MMMMXXV	MMMMXXV
MMCMXXV	MMCMXXV
MMLVI	MMLVI
MMDXXX	MMDXXX
MMMMCVII	MMMMCVII
MDC	MDC
MCCIII	MCCIII
MMMMDCC	MMMMDCC
MMCCLXXV	MMCCLXXV
MMDCCCXXXXVI	MMDCCCXLVI	changed
MMMMCCCLXV	MMMMCCCLXV
CDXIIII	CDXIV	changed
MLXIIII	MLXIV	changed
CCV	CCV
MMMCMXXXI	MMMCMXXXI
CCCCLXVI	CDLXVI	changed
MDXXXII	MDXXXII
MMMMCCCLVIII	MMMMCCCLVIII
MMV	MMV
MMMCLII	MMMCLII
MCMLI	MCMLI
MMDCCXX	MMDCCXX
MMMMCCCCXXXVI	MMMMCDXXXVI	changed
MCCLXXXI	MCCLXXXI
MMMCMVI	MMMCMVI
DCCXXX	DCCXXX
MMMMCCCLXV	MMMMCCCLXV
DCCCXI	DCCCXI
MMMMDCCCXIV	MMMMDCCCXIV
CCCXXI	CCCXXI
MMDLXXV	MMDLXXV
CCCCLXXXX	CCCCLXL	changed
MCCCLXXXXII	MCCCLXLII	changed
MMDCIX	MMDCIX
DCCXLIIII	DCCXLIV	changed
DXIV	DXIV
MMMMCLII	MMMMCLII
CDLXI	CDLXI
MMMCXXVII	MMMCXXVII
MMMMDCCCCLXIII	MMMMCMLXIII	changed
MMMDCLIIII	MMMDCLIV	changed
MCCCCXXXXII	MCCCCXLII	changed
MMCCCLX	MMCCCLX
CCCCLIII	CDLIII	changed
MDCCLXXVI	MDCCLXXVI
MCMXXIII	MCMXXIII
MMMMDLXXVIII	MMMMDLXXVIII
MMDCCCCLX	MMCMLX	changed
MMMCCCLXXXX	MMMCCCLXL	changed
MMMCDXXVI	MMMCDXXVI
MMMDLVIII	MMMDLVIII
CCCLXI	CCCLXI
MMMMDCXXII	MMMMDCXXII
MMDCCCXXI	MMDCCCXXI
MMDCCXIII	MMDCCXIII
MMMMCLXXXVI	MMMMCLXXXVI
MDCCCCXXVI	MCMXXVI	changed
MDV	MDV
MMDCCCCLXXVI	MMCMLXXVI	changed
MMMMCCXXXVII	MMMMCCXXXVII
MMMDCCLXXVIIII	MMMDCCLXXVIV	changed
MMMCCCCLXVII	MMMCDLXVII	changed
DCCXLI	DCCXLI
MMCLXXXVIII	MMCLXXXVIII
MCCXXXVI	MCCXXXVI
MMDCXLVIII	MMDCXLVIII
MMMMCXXXII	MMMMCXXXII
MMMMDCCLXVI	MMMMDCCLXVI
MMMMCMLI	MMMMCMLI
MMMMCLXV	MMMMCLXV
MMMMDCCCXCIV	MMMMDCCCXCIV
MCCLXXVII	MCCLXXVII
LXXVIIII	LXXVIV	changed
DCCLII	DCCLII
MMMCCCXCVI	MMMCCCXCVI
MMMCLV	MMMCLV
MMDCCCXXXXVIII	MMDCCCXLVIII	changed
DCCCXV	DCCCXV
MXC	MXC
MMDCCLXXXXVII	MMDCCLXLVII	changed
MMMMCML	MMMMCML
MMDCCCLXXVIII	MMDCCCLXXVIII
DXXI	DXXI
MCCCXLI	MCCCXLI
DCLXXXXI	DCLXLI	changed
MMCCCLXXXXVIII	MMCCCLXLVIII	changed
MDCCCCLXXVIII	MCMLXXVIII	changed
MMMMDXXV	MMMMDXXV
MMMDCXXXVI	MMMDCXXXVI
MMMCMXCVII	MMMCMXCVII
MMXVIIII	MMXVIV	changed
MMMDCCLXXIV	MMMDCCLXXIV
MMMCXXV	MMMCXXV
DXXXVIII	DXXXVIII
MMMMCLXVI	MMMMCLXVI
MDXII	MDXII
MMCCCLXX	MMCCCLXX
CCLXXI	CCLXXI
DXIV	DXIV
MMMCLIII	MMMCLIII
DLII	DLII
MMMCCCXLIX	MMMCCCXLIX
MMCCCCXXVI	MMCDXXVI	changed
MMDCXLIII	MMDCXLIII
MXXXXII	MXLII	changed
CCCLXXXV	CCCLXXXV
MDCLXXVI	MDCLXXVI
MDCXII	MDCXII
MMMCCCLXXXIII	MMMCCCLXXXIII
MMDCCCCLXXXII	MMCMLXXXII	changed
MMMMCCCLXXXV	MMMMCCCLXXXV
MMDCXXI	MMDCXXI
DCCCXXX	DCCCXXX
MMMDCCCCLII	MMMCMLII	changed
MMMDCCXXII	MMMDCCXXII
MMMMCDXCVIII	MMMMCDXCVIII
MMMCCLXVIIII	MMMCCLXVIV	changed
MMXXV	MMXXV
MMMMCDXIX	MMMMCDXIX
MMMMCCCX	MMMMCCCX
MMMCCCCLXVI	MMMCDLXVI	changed
MMMMDCLXXVIIII	MMMMDCLXXVIV	changed
MMMMDCXXXXIV	MMMMDCXLIV	changed
MMMCMXII	MMMCMXII
MMMMXXXIII	MMMMXXXIII
MMMMDLXXXII	MMMMDLXXXII
DCCCLIV	DCCCLIV
MDXVIIII	MDXVIV	changed
MMMCLXXXXV	MMMCLXLV	changed
CCCCXX	CDXX	changed
MMDIX	MMDIX
MMCMLXXXVIII	MMCMLXXXVIII
DCCXLIII	DCCXLIII
DCCLX	DCCLX
D	D
MCCCVII	MCCCVII
MMMMCCCLXXXIII	MMMMCCCLXXXIII
MDCCCLXXIIII	MDCCCLXXIV	changed
MMMDCCCCLXXXVII	MMMCMLXXXVII	changed
MMMMCCCVII	MMMMCCCVII
MMMDCCLXXXXVI	MMMDCCLXLVI	changed
CDXXXIV	CDXXXIV
MCCLXVIII	MCCLXVIII
MMMMDLX	MMMMDLX
MMMMDXII	MMMMDXII
MMMMCCCCLIIII	MMMMCCCCLIV	changed
MCMLXXXXIII	MCMLXLIII	changed
MMMMDCCCIII	MMMMDCCCIII
MMDCLXXXIII	MMDCLXXXIII
MDCCCXXXXIV	MDCCCXLIV	changed
XXXXVII	XLVII	changed
MMMDCCCXXXII	MMMDCCCXXXII
MMMDCCCXLII	MMMDCCCXLII
MCXXXV	MCXXXV
MDCXXVIIII	MDCXXVIV	changed
MMMCXXXXIIII	MMMCXLIIII	changed
MMMMCDXVII	MMMMCDXVII
MMMDXXIII	MMMDXXIII
MMMMCCCCLXI	MMMMCDLXI	changed
DCLXXXXVIIII	DCLXLVIIII	changed
LXXXXI	LXLI	changed
CXXXIII	CXXXIII
MCDX	MCDX
MCCLVII	MCCLVII
MDCXXXXII	MDCXLII	changed
MMMCXXIV	MMMCXXIV
MMMMLXXXX	MMMMLXL	changed
MMDCCCCXLV	MMCMXLV	changed
MLXXX	MLXXX
MMDCCCCLX	MMCMLX	changed
MCDLIII	MCDLIII
MMMCCCLXVII	MMMCCCLXVII
MMMMCCCLXXIV	MMMMCCCLXXIV
MMMDCVIII	MMMDCVIII
DCCCCXXIII	CMXXIII	changed
MMXCI	MMXCI
MMDCCIV	MMDCCIV
MMMMDCCCXXXIV	MMMMDCCCXXXIV
CCCLXXI	CCCLXXI
MCCLXXXII	MCCLXXXII
MCMIII	MCMIII
CCXXXI	CCXXXI
DCCXXXVIII	DCCXXXVIII
MMMMDCCXLVIIII	MMMMDCCXLVIV	changed
MMMMCMXXXV	MMMMCMXXXV
DCCCLXXV	DCCCLXXV
DCCXCI	DCCXCI
MMMMDVII	MMMMDVII
MMMMDCCCLXVIIII	MMMMDCCCLXVIV	changed
CCCXCV	CCCXCV
MMMMDCCXX	MMMMDCCXX
MCCCCII	MCDII	changed
MMMCCCXC	MMMCCCXC
MMMCCCII	MMMCCCII
MMDCCLXXVII	MMDCCLXXVII
MMDCLIIII	MMDCLIV	changed
CCXLIII	CCXLIII
MMMDCXVIII	MMMDCXVIII
MMMCCCIX	MMMCCCIX
MCXV	MCXV
MMCCXXV	MMCCXXV
MLXXIIII	MLXXIV	changed
MDCCXXVI	MDCCXXVI
MMMCCCXX	MMMCCCXX
MMDLXX	MMDLXX
MMCCCCVI	MMCDVI	changed
MMDCCXX	MMDCCXX
MMMMDCCCCXCV	MMMMCMXCV	changed
MDCCCXXXII	MDCCCXXXII
MMMMDCCCCXXXX	MMMMDCCCCXL	changed
XCIV	XCIV
MMCCCCLX	MMCDLX	changed
MMXVII	MMXVII
MLXXI	MLXXI
MMMDXXVIII	MMMDXXVIII
MDCCCCII	MCMII	changed
MMMCMLVII	MMMCMLVII
MMCLXXXXVIII	MMCLXLVIII	changed
MDCCCCLV	MCMLV	changed
MCCCCLXXIIII	MCCCCLXXIV	changed
MCCCLII	MCCCLII
MCDXLVI	MCDXLVI
MMMMDXVIII	MMMMDXVIII
DCCLXXXIX	DCCLXXXIX
MMMDCCLXIV	MMMDCCLXIV
MDCCCCXLIII	MCMXLIII	changed
CLXXXXV	CLXLV	changed
MMMMCCXXXVI	MMMMCCXXXVI
MMMDCCCXXI	MMMDCCCXXI
MMMMCDLXXVII	MMMMCDLXXVII
MCDLIII	MCDLIII
MMCCXLVI	MMCCXLVI
DCCCLV	DCCCLV
MCDLXX	MCDLXX
DCLXXVIII	DCLXXVIII
MMDCXXXIX	MMDCXXXIX
MMMMDCLX	MMMMDCLX
MMDCCLI	MMDCCLI
MMCXXXV	MMCXXXV
MMMCCXII	MMMCCXII
MMMMCMLXII	MMMMCMLXII
MMMMCCV	MMMMCCV
MCCCCLXIX	MCDLXIX	changed
MMMMCCIII	MMMMCCIII
CLXVII	CLXVII
MCCCLXXXXIIII	MCCCLXLIIII	changed
MMMMDCVIII	MMMMDCVIII
MMDCCCLXI	MMDCCCLXI
MMLXXIX	MMLXXIX
CMLXIX	CMLXIX
MMDCCCXLVIIII	MMDCCCXLVIV	changed
DCLXII	DCLXII
MMMCCCXLVII	MMMCCCXLVII
MDCCCXXXV	MDCCCXXXV
MMMMDCCXCVI	MMMMDCCXCVI
DCXXX	DCXXX
XXVI	XXVI
MMLXIX	MMLXIX
MMCXI	MMCXI
DCXXXVII	DCXXXVII
MMMMCCCXXXXVIII	MMMMCCCXLVIII	changed
MMMMDCLXI	MMMMDCLXI
MMMMDCLXXIIII	MMMMDCLXXIV	changed
MMMMVIII	MMMMVIII
MMMMDCCCLXII	MMMMDCCCLXII
MDCXCI	MDCXCI
MMCCCXXIIII	MMCCCXXIV	changed
CCCCXXXXV	CCCCXLV	changed
MMDCCCXXI	MMDCCCXXI
MCVI	MCVI
MMDCCLXVIII	MMDCCLXVIII
MMMMCXL	MMMMCXL
MLXVIII	MLXVIII
CMXXVII	CMXXVII
CCCLV	CCCLV
MDCCLXXXIX	MDCCLXXXIX
MMMCCCCLXV	MMMCDLXV	changed
MMDCCLXII	MMDCCLXII
MDLXVI	MDLXVI
MMMCCCXVIII	MMMCCCXVIII
MMMMCCLXXXI	MMMMCCLXXXI
MMCXXVII	MMCXXVII
MMDCCCLXVIII	MMDCCCLXVIII
MMMCXCII	MMMCXCII
MMMMDCLVIII	MMMMDCLVIII
MMMMDCCCXXXXII	MMMMDCCCXLII	changed
MMDCCCCLXXXXVI	MMDCCCCLXLVI	changed
MDCCXL	MDCCXL
MDCCLVII	MDCCLVII
MMMMDCCCLXXXVI	MMMMDCCCLXXXVI
DCCXXXIII	DCCXXXIII
MMMMDCCCCLXXXV	MMMMCMLXXXV	changed
MMCCXXXXVIII	MMCCXLVIII	changed
MMMCCLXXVIII	MMMCCLXXVIII
MMMDCLXXVIII	MMMDCLXXVIII
DCCCI	DCCCI
MMMMLXXXXVIIII	MMMMLXLVIIII	changed
MMMCCCCLXXII	MMMCDLXXII	changed
MMCLXXXVII	MMCLXXXVII
CCLXVI	CCLXVI
MCDXLIII	MCDXLIII
MMCXXVIII	MMCXXVIII
MDXIV	MDXIV
CCCXCVIII	CCCXCVIII
CLXXVIII	CLXXVIII
MMCXXXXVIIII	MMCXLVIIII	changed
MMMDCLXXXIV	MMMDCLXXXIV
CMLVIII	CMLVIII
MCDLIX	MCDLIX
MMMMDCCCXXXII	MMMMDCCCXXXII
MMMMDCXXXIIII	MMMMDCXXXIV	changed
MDCXXI	MDCXXI
MMMDCXLV	MMMDCXLV
MCLXXVIII	MCLXXVIII
MCDXXII	MCDXXII
IV	IV
MCDLXXXXIII	MCDLXLIII	changed
MMMMDCCLXV	MMMMDCCLXV
CCLI	CCLI
MMMMDCCCXXXVIII	MMMMDCCCXXXVIII
DCLXII	DCLXII
MCCCLXVII	MCCCLXVII
MMMMDCCCXXXVI	MMMMDCCCXXXVI
MMDCCXLI	MMDCCXLI
MLXI	MLXI
MMMCDLXVIII	MMMCDLXVIII
MCCCCXCIII	MCDXCIII	changed
XXXIII	XXXIII
MMMDCLXIII	MMMDCLXIII
MMMMDCL	MMMMDCL
DCCCXXXXIIII	DCCCXLIIII	changed
MMDLVII	MMDLVII
DXXXVII	DXXXVII
MCCCCXXIIII	MCCCCXXIV	changed
MCVII	MCVII
MMMMDCCXL	MMMMDCCXL
MMMMCXXXXIIII	MMMMCXLIIII	changed
MCCCCXXIV	MCDXXIV	changed
MMCLXVIII	MMCLXVIII
MMXCIII	MMXCIII
MDCCLXXX	MDCCLXXX
MCCCLIIII	MCCCLIV	changed
MMDCLXXI	MMDCLXXI
MXI	MXI
MCMLIV	MCMLIV
MMMCCIIII	MMMCCIV	changed
DCCLXXXVIIII	DCCLXXXVIV	changed
MDCLIV	MDCLIV
MMMDCXIX	MMMDCXIX
CMLXXXI	CMLXXXI
DCCLXXXVII	DCCLXXXVII
XXV	XXV
MMMXXXVI	MMMXXXVI
MDVIIII	MDVIV	changed
CLXIII	CLXIII
MMMCDLVIIII	MMMCDLVIV	changed
MMCCCCVII	MMCDVII	changed
MMMLXX	MMMLXX
MXXXXII	MXLII	changed
MMMMCCCLXVIII	MMMMCCCLXVIII
MMDCCCXXVIII	MMDCCCXXVIII
MMMMDCXXXXI	MMMMDCXLI	changed
MMMMDCCCXXXXV	MMMMDCCCXLV	changed
MMMXV	MMMXV
MMMMCCXVIIII	MMMMCCXVIV	changed
MMDCCXIIII	MMDCCXIV	changed
MMMXXVII	MMMXXVII
MDCCLVIIII	MDCCLVIV	changed
MMCXXIIII	MMCXXIV	changed
MCCCLXXIV	MCCCLXXIV
DCLVIII	DCLVIII
MMMLVII	MMMLVII
MMMCXLV	MMMCXLV
MMXCVII	MMXCVII
MMMCCCLXXXVII	MMMCCCLXXXVII
MMMMCCXXII	MMMMCCXXII
DXII	DXII
MMMDLV	MMMDLV
MCCCLXXVIII	MCCCLXXVIII
MMMCLIIII	MMMCLIV	changed
MMMMCLXXXX	MMMMCLXL	changed
MMMCLXXXIIII	MMMCLXXXIV	changed
MDCXXIII	MDCXXIII
MMMMCCXVI	MMMMCCXVI
MMMMDLXXXIII	MMMMDLXXXIII
MMMDXXXXIII	MMMDXLIII	changed
MMMMCCCCLV	MMMMCDLV	changed
MMMDLXXXI	MMMDLXXXI
MMMCCLXXVI	MMMCCLXXVI
MMMMXX	MMMMXX
MMMMDLVI	MMMMDLVI
MCCCCLXXX	MCDLXXX	changed
MMMXXII	MMMXXII
MMXXII	MMXXII
MMDCCCCXXXI	MMCMXXXI	changed
MMMDXXV	MMMDXXV
MMMDCLXXXVIIII	MMMDCLXXXVIV	changed
MMMDLXXXXVII	MMMDLXLVII	changed
MDLXIIII	MDLXIV	changed
CMXC	CMXC
MMMXXXVIII	MMMXXXVIII
MDLXXXVIII	MDLXXXVIII
MCCCLXXVI	MCCCLXXVI
MMCDLIX	MMCDLIX
MMDCCCXVIII	MMDCCCXVIII
MDCCCXXXXVI	MDCCCXLVI	changed
MMMMCMIV	MMMMCMIV
MMMMDCIIII	MMMMDCIV	changed
MMCCXXXV	MMCCXXXV
XXXXVI	XLVI	changed
MMMMCCXVII	MMMMCCXVII
MMCCXXIV	MMCCXXIV
MCMLVIIII	MCMLVIV	changed
MLXXXIX	MLXXXIX
MMMMLXXXIX	MMMMLXXXIX
CLXXXXIX	CLXLIX	changed
MMMDCCCCLVIII	MMMCMLVIII	changed
MMMMCCLXXIII	MMMMCCLXXIII
MCCCC	MCD	changed
DCCCLIX	DCCCLIX
MMMCCCLXXXII	MMMCCCLXXXII
MMMCCLXVIIII	MMMCCLXVIV	changed
MCLXXXV	MCLXXXV
CDLXXXVII	CDLXXXVII
DCVI	DCVI
MMX	MMX
MMCCXIII	MMCCXIII
MMMMDCXX	MMMMDCXX
MMMMXXVIII	MMMMXXVIII
DCCCLXII	DCCCLXII
MMMMCCCXLIII	MMMMCCCXLIII
MMMMCLXV	MMMMCLXV
DXCI	DXCI
MMMMCLXXX	MMMMCLXXX
MMMDCCXXXXI	MMMDCCXLI	changed
MMMMXXXXVI	MMMMXLVI	changed
DCLX	DCLX
MMMCCCXI	MMMCCCXI
MCCLXXX	MCCLXXX
MMCDLXXII	MMCDLXXII
DCCLXXI	DCCLXXI
MMMCCCXXXVI	MMMCCCXXXVI
MCCCCLXXXVIIII	MCCCCLXXXVIV	changed
CDLVIII	CDLVIII
DCCLVI	DCCLVI
MMMMDCXXXVIII	MMMMDCXXXVIII
MMCCCLXXXIII	MMCCCLXXXIII
MMMMDCCLXXV	MMMMDCCLXXV
MMMXXXVI	MMMXXXVI
CCCLXXXXIX	CCCLXLIX	changed
CV	CV
CCCCXIII	CDXIII	changed
CCCCXVI	CDXVI	changed
MDCCCLXXXIIII	MDCCCLXXXIV	changed
MMDCCLXXXII	MMDCCLXXXII
MMMMCCCCLXXXI	MMMMCDLXXXI	changed
MXXV	MXXV
MMCCCLXXVIIII	MMCCCLXXVIV	changed
MMMCCXII	MMMCCXII
MMMMCCXXXIII	MMMMCCXXXIII
MMCCCLXXXVI	MMCCCLXXXVI
MMMDCCCLVIIII	MMMDCCCLVIV	changed
MCCXXXVII	MCCXXXVII
MDCLXXV	MDCLXXV
XXXV	XXXV
MMDLI	MMDLI
MMMCCXXX	MMMCCXXX
MMMMCXXXXV	MMMMCXLV	changed
CCCCLIX	CDLIX	changed
MMMMDCCCLXXIII	MMMMDCCCLXXIII
MMCCCXVII	MMCCCXVII
DCCCXVI	DCCCXVI
MMMCCCXXXXV	MMMCCCXLV	changed
MDCCCCXCV	MCMXCV	changed
CLXXXI	CLXXXI
MMMMDCCLXX	MMMMDCCLXX
MMMDCCCIII	MMMDCCCIII
MMCLXXVII	MMCLXXVII
MMMDCCXXIX	MMMDCCXXIX
MMDCCCXCIIII	MMDCCCXCIV	changed
MMMCDXXIIII	MMMCDXXIV	changed
MMMMXXVIII	MMMMXXVIII
MMMMDCCCCLXVIII	MMMMCMLXVIII	changed
MDCCCXX	MDCCCXX
MMMMCDXXI	MMMMCDXXI
MMMMDLXXXIX	MMMMDLXXXIX
CCXVI	CCXVI
MDVIII	MDVIII
MMCCLXXI	MMCCLXXI
MMMDCCCLXXI	MMMDCCCLXXI
MMMCCCLXXVI	MMMCCCLXXVI
MMCCLXI	MMCCLXI
MMMMDCCCXXXIV	MMMMDCCCXXXIV
DLXXXVI	DLXXXVI
MMMMDXXXII	MMMMDXXXII
MMMXXIIII	MMMXXIV	changed
MMMMCDIV	MMMMCDIV
MMMMCCCXLVIII	MMMMCCCXLVIII
MMMMCXXXVIII	MMMMCXXXVIII
MMMCCCLXVI	MMMCCCLXVI
MDCCXVIII	MDCCXVIII
MMCXX	MMCXX
CCCLIX	CCCLIX
MMMMDCCLXXII	MMMMDCCLXXII
MDCCCLXXV	MDCCCLXXV
MMMMDCCCXXIV	MMMMDCCCXXIV
DCCCXXXXVIII	DCCCXLVIII	changed
MMMDCCCCXXXVIIII	MMMDCCCCXXXVIV	changed
MMMMCCXXXV	MMMMCCXXXV
MDCLXXXIII	MDCLXXXIII
MMCCLXXXIV	MMCCLXXXIV
MCLXXXXIIII	MCLXLIIII	changed
DXXXXIII	DXLIII	changed
MCCCXXXXVIII	MCCCXLVIII	changed
MMCLXXIX	MMCLXXIX
MMMMCCLXIV	MMMMCCLXIV
MXXII	MXXII
MMMCXIX	MMMCXIX
MDCXXXVII	MDCXXXVII
MMDCCVI	MMDCCVI
MCLXXXXVIII	MCLXLVIII	changed
MMMCXVI	MMMCXVI
MCCCLX	MCCCLX
MMMCDX	MMMCDX
CCLXVIIII	CCLXVIV	changed
MMMCCLX	MMMCCLX
MCXXVIII	MCXXVIII
LXXXII	LXXXII
MCCCCLXXXI	MCDLXXXI	changed
MMMI	MMMI
MMMCCCLXIV	MMMCCCLXIV
MMMCCCXXVIIII	MMMCCCXXVIV	changed
CXXXVIII	CXXXVIII
MMCCCXX	MMCCCXX
MMMCCXXVIIII	MMMCCXXVIV	changed
MCCLXVI	MCCLXVI
MMMCCCCXXXXVI	MMMCCCCXLVI	changed
MMDCCXCIX	MMDCCXCIX
MCMLXXI	MCMLXXI
MMCCLXVIII	MMCCLXVIII
CDLXXXXIII	CDLXLIII	changed
MMMMDCCXXII	MMMMDCCXXII
MMMMDCCLXXXVII	MMMMDCCLXXXVII
MMMDCCLIV	MMMDCCLIV
MMCCLXIII	MMCCLXIII
MDXXXVII	MDXXXVII
DCCXXXIIII	DCCXXXIV	changed
MCII	MCII
MMMDCCCLXXI	MMMDCCCLXXI
MMMLXXIII	MMMLXXIII
MDCCCLIII	MDCCCLIII
MMXXXVIII	MMXXXVIII
MDCCXVIIII	MDCCXVIV	changed
MDCCCCXXXVII	MCMXXXVII	changed
MMCCCXVI	MMCCCXVI
MCMXXII	MCMXXII
MMMCCCLVIII	MMMCCCLVIII
MMMMDCCCXX	MMMMDCCCXX
MCXXIII	MCXXIII
MMMDLXI	MMMDLXI
MMMMDXXII	MMMMDXXII
MDCCCX	MDCCCX
MMDXCVIIII	MMDXCVIV	changed
MMMDCCCCVIII	MMMCMVIII	changed
MMMMDCCCCXXXXVI	MMMMDCCCCXLVI	changed
MMDCCCXXXV	MMDCCCXXXV
MMCXCIV	MMCXCIV
MCMLXXXXIII	MCMLXLIII	changed
MMMCCCLXXVI	MMMCCCLXXVI
MMMMDCLXXXV	MMMMDCLXXXV
CMLXIX	CMLXIX
DCXCII	DCXCII
MMXXVIII	MMXXVIII
MMMMCCCXXX	MMMMCCCXXX
XXXXVIIII	XLVIIII	changed
